Date,Overview page views (desktop),Overview page views (mobile),Overview page views (total),Overview unique visitors (desktop),Overview unique visitors (mobile),Overview unique visitors (total),Life page views (desktop),Life page views (mobile),Life page views (total),Life unique visitors (desktop),Life unique visitors (mobile),Life unique visitors (total),Jobs page views (desktop),Jobs page views (mobile),Jobs page views (total),Jobs unique visitors (desktop),Jobs unique visitors (mobile),Jobs unique visitors (total),Total page views (desktop),Total page views (mobile),Total page views (total),Total unique visitors (desktop),Total unique visitors (mobile),Total unique visitors (total)
08/12/2023,9,26,35,4,12,16,0,0,0,0,0,0,2,0,2,1,0,1,13,27,40,4,12,16
08/13/2023,3,22,25,3,10,13,0,0,0,0,0,0,1,0,1,1,0,1,4,23,27,3,10,13
08/14/2023,8,48,56,6,19,25,0,0,0,0,0,0,1,1,2,1,1,2,12,53,65,6,19,25
08/15/2023,38,30,68,18,12,30,0,0,0,0,0,0,1,0,1,1,0,1,45,35,80,18,12,30
08/16/2023,18,34,52,16,15,31,0,0,0,0,0,0,1,2,3,1,1,2,22,43,65,16,15,31
08/17/2023,24,27,51,13,12,25,0,0,0,0,0,0,1,0,1,1,0,1,35,27,62,14,12,26
08/18/2023,13,25,38,10,6,16,0,0,0,0,0,0,0,0,0,0,0,0,18,26,44,10,6,16
08/19/2023,7,10,17,5,6,11,0,0,0,0,0,0,1,0,1,1,0,1,10,11,21,5,6,11
08/20/2023,7,56,63,5,28,33,0,0,0,0,0,0,3,1,4,2,1,3,14,65,79,5,28,33
08/21/2023,16,53,69,11,26,37,0,0,0,0,0,0,0,1,1,0,1,1,18,55,73,11,26,37
08/22/2023,56,185,241,47,91,137,0,0,0,0,0,0,4,2,6,4,2,6,68,208,276,47,91,137
08/23/2023,28,62,90,20,33,53,0,0,0,0,0,0,2,0,2,2,0,2,37,67,104,20,33,53
08/24/2023,15,35,50,8,15,23,0,0,0,0,0,0,1,0,1,1,0,1,25,38,63,8,15,23
08/25/2023,22,50,72,13,23,36,0,0,0,0,0,0,1,4,5,1,4,5,27,67,94,13,23,36
08/26/2023,2,24,26,2,9,11,0,0,0,0,0,0,0,2,2,0,2,2,3,27,30,2,9,11
08/27/2023,11,33,44,5,13,18,0,0,0,0,0,0,0,0,0,0,0,0,13,36,49,6,13,19
08/28/2023,22,26,48,13,14,27,0,0,0,0,0,0,1,2,3,1,1,2,27,33,60,13,14,27
08/29/2023,27,18,45,7,12,19,0,0,0,0,0,0,4,0,4,2,0,2,40,19,59,7,12,19
08/30/2023,16,47,63,11,17,28,0,0,0,0,0,0,0,0,0,0,0,0,20,52,72,11,17,28
08/31/2023,16,19,35,8,9,17,0,0,0,0,0,0,4,1,5,1,1,2,25,25,50,9,9,18
09/01/2023,12,38,50,7,15,22,0,0,0,0,0,0,1,0,1,1,0,1,18,44,62,7,15,22
09/02/2023,5,37,42,4,16,20,0,0,0,0,0,0,0,0,0,0,0,0,5,46,51,4,16,20
09/03/2023,2,22,24,2,11,13,0,0,0,0,0,0,0,0,0,0,0,0,3,27,30,2,11,13
09/04/2023,5,31,36,5,14,19,0,0,0,0,0,0,0,3,3,0,1,1,5,35,40,5,14,19
09/05/2023,14,29,43,8,8,16,0,0,0,0,0,0,2,1,3,1,1,2,19,35,54,8,8,16
09/06/2023,12,39,51,10,14,24,0,0,0,0,0,0,0,2,2,0,2,2,13,42,55,10,14,24
09/07/2023,20,30,50,13,14,27,0,0,0,0,0,0,1,0,1,1,0,1,25,34,59,13,14,27
09/08/2023,17,39,56,10,15,25,0,0,0,0,0,0,3,0,3,1,0,1,25,40,65,10,15,25
09/09/2023,8,26,34,7,13,20,0,0,0,0,0,0,1,1,2,1,1,2,9,35,44,7,13,20
09/10/2023,4,35,39,3,15,18,0,0,0,0,0,0,1,0,1,1,0,1,6,35,41,3,15,18
09/11/2023,2,37,39,2,14,16,0,0,0,0,0,0,0,0,0,0,0,0,2,43,45,2,14,16
09/12/2023,9,33,42,6,18,24,0,0,0,0,0,0,0,2,2,0,2,2,12,36,48,6,18,24
09/13/2023,18,48,66,12,19,31,0,0,0,0,0,0,1,0,1,1,0,1,21,52,73,12,19,31
09/14/2023,15,26,41,10,10,20,0,0,0,0,0,0,1,0,1,1,0,1,20,27,47,10,10,20
09/15/2023,10,13,23,8,8,16,0,0,0,0,0,0,0,2,2,0,2,2,16,15,31,8,8,16
09/16/2023,4,20,24,3,11,14,0,0,0,0,0,0,1,1,2,1,1,2,7,23,30,3,11,14
09/17/2023,5,29,34,5,6,11,0,0,0,0,0,0,1,0,1,1,0,1,9,31,40,5,6,11
09/18/2023,9,26,35,7,13,20,0,0,0,0,0,0,0,0,0,0,0,0,13,30,43,7,13,20
09/19/2023,14,35,49,8,16,24,0,0,0,0,0,0,2,1,3,2,1,3,20,41,61,8,16,24
09/20/2023,12,29,41,7,13,20,0,0,0,0,0,0,0,1,1,0,1,1,16,32,48,7,13,20
09/21/2023,5,40,45,5,14,19,0,0,0,0,0,0,0,1,1,0,1,1,6,43,49,5,14,19
09/22/2023,8,36,44,4,12,16,0,0,0,0,0,0,0,0,0,0,0,0,9,38,47,4,12,16
09/23/2023,1,11,12,1,4,5,0,0,0,0,0,0,0,0,0,0,0,0,1,11,12,1,4,5
09/24/2023,1,30,31,1,13,14,0,0,0,0,0,0,0,1,1,0,1,1,1,32,33,1,13,14
09/25/2023,13,18,31,9,9,18,0,0,0,0,0,0,1,0,1,1,0,1,14,19,33,9,9,18
09/26/2023,6,42,48,6,11,17,0,0,0,0,0,0,0,2,2,0,2,2,9,52,61,6,11,17
09/27/2023,8,6,14,7,4,11,0,0,0,0,0,0,3,0,3,2,0,2,16,6,22,8,4,12
09/28/2023,6,32,38,5,13,18,0,0,0,0,0,0,0,0,0,0,0,0,8,35,43,6,13,19
09/29/2023,3,15,18,3,11,14,0,0,0,0,0,0,0,0,0,0,0,0,6,15,21,3,11,14
09/30/2023,7,10,17,5,4,9,0,0,0,0,0,0,2,0,2,2,0,2,10,12,22,5,4,9
10/01/2023,1,15,16,1,7,8,0,0,0,0,0,0,0,0,0,0,0,0,1,19,20,1,7,8
10/02/2023,11,39,50,7,23,30,0,0,0,0,0,0,1,3,4,1,2,3,14,44,58,7,23,30
10/03/2023,5,58,63,3,18,21,0,0,0,0,0,0,0,2,2,0,1,1,5,66,71,3,18,21
10/04/2023,13,32,45,10,18,28,0,0,0,0,0,0,2,0,2,2,0,2,19,38,57,10,18,28
10/05/2023,18,11,29,10,6,16,0,0,0,0,0,0,0,0,0,0,0,0,20,13,33,11,6,17
10/06/2023,9,13,22,6,7,13,0,0,0,0,0,0,5,0,5,2,0,2,16,14,30,6,7,13
10/07/2023,7,8,15,3,5,8,0,0,0,0,0,0,0,0,0,0,0,0,9,11,20,3,5,8
10/08/2023,1,9,10,1,6,7,0,0,0,0,0,0,0,0,0,0,0,0,1,11,12,1,6,7
10/09/2023,24,14,38,12,6,18,0,0,0,0,0,0,1,1,2,1,1,2,38,15,53,12,6,18
10/10/2023,9,14,23,5,7,12,0,0,0,0,0,0,3,0,3,2,0,2,16,17,33,5,7,12
10/11/2023,12,28,40,9,14,23,0,0,0,0,0,0,2,0,2,2,0,2,16,34,50,10,14,24
10/12/2023,8,6,14,6,4,10,0,0,0,0,0,0,0,0,0,0,0,0,17,8,25,6,4,10
10/13/2023,10,7,17,4,5,9,0,0,0,0,0,0,0,0,0,0,0,0,13,7,20,4,5,9
10/14/2023,3,7,10,3,5,8,0,0,0,0,0,0,0,0,0,0,0,0,3,8,11,3,5,8
10/15/2023,2,19,21,1,8,9,0,0,0,0,0,0,0,0,0,0,0,0,2,22,24,1,8,9
10/16/2023,9,22,31,5,9,14,0,0,0,0,0,0,0,0,0,0,0,0,12,22,34,5,9,14
10/17/2023,16,8,24,10,5,15,0,0,0,0,0,0,0,0,0,0,0,0,20,8,28,10,5,15
10/18/2023,15,29,44,6,12,18,0,0,0,0,0,0,0,0,0,0,0,0,15,34,49,6,12,18
10/19/2023,5,11,16,3,8,11,0,0,0,0,0,0,0,0,0,0,0,0,5,12,17,3,8,11
10/20/2023,4,15,19,4,9,13,0,0,0,0,0,0,0,0,0,0,0,0,4,15,19,4,9,13
10/21/2023,9,27,36,4,9,13,0,0,0,0,0,0,4,0,4,1,0,1,16,28,44,4,9,13
10/22/2023,5,30,35,4,9,13,0,0,0,0,0,0,1,0,1,1,0,1,9,36,45,4,9,13
10/23/2023,12,26,38,8,6,14,0,0,0,0,0,0,0,0,0,0,0,0,12,26,38,8,6,14
10/24/2023,14,13,27,9,8,17,0,0,0,0,0,0,0,0,0,0,0,0,17,14,31,9,8,17
10/25/2023,19,18,37,9,9,18,0,0,0,0,0,0,2,0,2,1,0,1,22,23,45,9,9,18
10/26/2023,16,31,47,11,9,19,0,0,0,0,0,0,5,0,5,5,0,5,33,49,82,12,9,20
10/27/2023,3,17,20,3,6,9,0,0,0,0,0,0,0,0,0,0,0,0,4,17,21,3,6,9
10/28/2023,13,13,26,4,8,12,0,0,0,0,0,0,0,0,0,0,0,0,14,17,31,4,8,12
10/29/2023,1,10,11,1,5,6,0,0,0,0,0,0,0,0,0,0,0,0,1,10,11,1,5,6
10/30/2023,5,30,35,4,11,15,0,0,0,0,0,0,0,0,0,0,0,0,5,31,36,4,11,15
10/31/2023,7,18,25,7,6,13,0,0,0,0,0,0,0,1,1,0,1,1,8,24,32,7,6,13
11/01/2023,9,19,28,6,10,16,0,0,0,0,0,0,1,1,2,1,1,2,12,20,32,6,10,16
11/02/2023,13,45,58,10,23,33,0,0,0,0,0,0,1,2,3,1,2,3,18,50,68,10,23,33
11/03/2023,12,52,64,7,22,29,0,0,0,0,0,0,0,4,4,0,1,1,12,63,75,7,22,29
11/04/2023,6,61,67,6,35,41,0,0,0,0,0,0,0,1,1,0,1,1,7,72,79,6,35,41
11/05/2023,22,97,119,13,50,62,0,0,0,0,0,0,3,0,3,3,0,3,28,119,147,13,50,62
11/06/2023,54,132,186,32,50,82,0,0,0,0,0,0,4,7,11,4,3,7,64,155,219,32,50,82
11/07/2023,33,115,148,26,53,79,0,0,0,0,0,0,1,1,2,1,1,2,40,125,165,26,53,79
11/08/2023,36,98,134,21,46,67,0,0,0,0,0,0,1,2,3,1,2,3,40,105,145,22,46,68
11/09/2023,20,56,76,9,28,37,0,0,0,0,0,0,1,0,1,1,0,1,28,58,86,9,28,37
11/10/2023,19,44,63,14,25,39,0,0,0,0,0,0,1,0,1,1,0,1,25,45,70,14,25,39
11/11/2023,13,103,116,10,45,54,0,0,0,0,0,0,0,1,1,0,1,1,15,116,131,10,45,54
11/12/2023,13,96,109,9,53,62,0,0,0,0,0,0,1,2,3,1,2,3,16,108,124,9,53,62
11/13/2023,37,139,176,32,71,103,0,0,0,0,0,0,3,0,3,3,0,3,46,146,192,32,71,103
11/14/2023,23,150,173,23,68,91,0,0,0,0,0,0,3,4,7,3,3,6,29,172,201,25,68,93
11/15/2023,22,110,132,15,53,68,0,0,0,0,0,0,3,4,7,3,3,6,29,120,149,15,53,68
11/16/2023,27,55,82,19,23,42,0,0,0,0,0,0,0,1,1,0,1,1,32,63,95,19,23,42
11/17/2023,8,34,42,4,17,21,0,0,0,0,0,0,0,1,1,0,1,1,8,36,44,4,17,21
11/18/2023,11,38,49,5,19,24,0,0,0,0,0,0,1,8,9,1,3,4,17,52,69,5,19,24
11/19/2023,16,223,239,15,97,111,0,0,0,0,0,0,2,5,7,2,2,4,19,266,285,16,98,113
11/20/2023,21,69,90,15,28,43,0,0,0,0,0,0,0,4,4,0,4,4,25,76,101,15,28,43
11/21/2023,17,83,100,14,32,46,0,0,0,0,0,0,0,0,0,0,0,0,18,89,107,14,32,46
11/22/2023,15,103,118,11,37,48,0,0,0,0,0,0,1,2,3,1,1,2,19,109,128,11,37,48
11/23/2023,36,129,165,27,67,94,0,0,0,0,0,0,2,0,2,2,0,2,44,145,189,27,67,94
11/24/2023,27,121,148,16,55,70,0,0,0,0,0,0,0,1,1,0,1,1,36,134,170,16,55,70
11/25/2023,12,66,78,9,36,45,0,0,0,0,0,0,1,0,1,1,0,1,14,75,89,9,36,45
11/26/2023,8,139,147,7,51,58,0,0,0,0,0,0,0,2,2,0,2,2,10,155,165,7,51,58
11/27/2023,56,128,184,20,62,81,0,0,0,0,0,0,3,4,7,3,3,6,71,158,229,20,62,81
11/28/2023,50,160,210,33,82,115,0,0,0,0,0,0,6,1,7,5,1,6,60,172,232,34,82,116
11/29/2023,44,226,270,34,109,139,0,0,0,0,0,0,2,4,6,2,3,5,52,258,310,35,109,140
11/30/2023,46,226,272,32,113,144,0,0,0,0,0,0,2,2,4,2,2,4,64,234,298,33,113,145
12/01/2023,35,190,225,27,81,108,0,0,0,0,0,0,1,2,3,1,2,3,38,211,249,27,81,108
12/02/2023,22,190,212,19,95,114,0,0,0,0,0,0,1,3,4,1,3,4,28,211,239,19,95,114
12/03/2023,22,231,253,15,109,124,0,0,0,0,0,0,2,0,2,1,0,1,28,250,278,15,109,124
12/04/2023,48,208,256,40,104,144,0,0,0,0,0,0,2,5,7,2,4,6,57,244,301,40,106,146
12/05/2023,39,223,262,35,112,147,0,0,0,0,0,0,0,9,9,0,7,7,46,258,304,36,112,148
12/06/2023,19,101,120,17,44,61,0,0,0,0,0,0,0,2,2,0,2,2,20,114,134,18,44,62
12/07/2023,30,114,144,21,53,74,0,0,0,0,0,0,5,2,7,3,2,5,40,127,167,21,53,74
12/08/2023,8,34,42,6,20,26,0,0,0,0,0,0,0,0,0,0,0,0,9,38,47,7,20,27
12/09/2023,7,68,75,7,19,26,0,0,0,0,0,0,1,1,2,1,1,2,8,73,81,7,19,26
12/10/2023,20,44,64,10,16,26,0,0,0,0,0,0,2,0,2,1,0,1,22,45,67,10,16,26
12/11/2023,20,40,60,8,19,27,0,0,0,0,0,0,0,0,0,0,0,0,22,45,67,9,19,28
12/12/2023,25,58,83,20,30,50,0,0,0,0,0,0,0,2,2,0,2,2,27,66,93,20,31,51
12/13/2023,31,93,124,26,50,76,0,0,0,0,0,0,4,3,7,4,3,7,45,102,147,27,50,77
12/14/2023,18,75,93,17,32,49,0,0,0,0,0,0,0,2,2,0,2,2,18,83,101,17,32,49
12/15/2023,18,38,56,13,21,34,0,0,0,0,0,0,2,0,2,2,0,2,26,43,69,13,21,34
12/16/2023,9,60,69,6,23,29,0,0,0,0,0,0,0,1,1,0,1,1,12,70,82,6,23,29
12/17/2023,8,38,46,7,15,22,0,0,0,0,0,0,1,0,1,1,0,1,11,39,50,7,15,22
12/18/2023,7,20,27,7,11,18,0,0,0,0,0,0,0,0,0,0,0,0,11,20,31,7,11,18
12/19/2023,15,43,58,10,17,27,0,0,0,0,0,0,0,0,0,0,0,0,18,50,68,10,17,27
12/20/2023,18,64,82,12,19,31,0,0,0,0,0,0,1,0,1,1,0,1,25,66,91,12,19,31
12/21/2023,12,88,100,10,41,51,0,0,0,0,0,0,2,2,4,1,2,3,16,95,111,10,41,51
12/22/2023,31,148,179,24,68,92,0,0,0,0,0,0,2,0,2,1,0,1,35,165,200,24,68,92
12/23/2023,18,233,251,15,109,122,0,0,0,0,0,0,3,4,7,3,4,7,28,279,307,15,109,122
12/24/2023,27,169,196,22,79,101,0,0,0,0,0,0,2,0,2,2,0,2,30,189,219,22,79,101
12/25/2023,22,183,205,18,88,106,0,0,0,0,0,0,2,1,3,2,1,3,28,199,227,18,88,106
12/26/2023,32,232,264,25,104,129,0,0,0,0,0,0,4,2,6,3,2,5,41,251,292,25,104,129
12/27/2023,27,239,266,24,108,132,0,0,0,0,0,0,3,7,10,3,4,7,32,268,300,24,108,132
12/28/2023,41,174,215,32,75,105,0,0,0,0,0,0,2,1,3,2,1,3,53,188,241,32,75,105
12/29/2023,37,268,305,24,113,137,0,0,0,0,0,0,4,2,6,3,2,5,47,285,332,24,113,137
12/30/2023,20,193,213,16,83,96,0,0,0,0,0,0,4,3,7,3,2,5,29,223,252,16,83,96
12/31/2023,19,208,227,11,84,94,0,0,0,0,0,0,1,5,6,1,4,5,27,235,262,11,84,94
01/01/2024,26,280,306,22,99,120,0,0,0,0,0,0,0,2,2,0,2,2,29,302,331,23,99,121
01/02/2024,69,279,348,47,127,173,0,0,0,0,0,0,5,5,10,3,4,7,88,324,412,48,127,174
01/03/2024,69,183,252,42,78,120,0,0,0,0,0,0,2,1,3,2,1,3,83,205,288,44,78,122
01/04/2024,53,249,302,40,110,150,0,0,0,0,0,0,4,3,7,4,3,7,66,273,339,40,111,151
01/05/2024,40,158,198,28,85,113,0,0,0,0,0,0,1,2,3,1,2,3,44,169,213,29,85,114
01/06/2024,22,313,335,21,131,152,0,0,0,0,0,0,0,6,6,0,4,4,22,337,359,21,131,152
01/07/2024,19,214,233,10,92,101,0,0,0,0,0,0,4,1,5,3,1,4,23,231,254,10,92,101
01/08/2024,53,231,284,39,96,131,0,0,0,0,0,0,5,5,10,4,4,8,70,267,337,39,96,131
01/09/2024,49,208,257,25,92,116,0,0,0,0,0,0,3,4,7,2,4,6,59,226,285,25,92,116
01/10/2024,50,131,181,30,52,82,0,0,0,0,0,0,5,3,8,4,2,6,68,139,207,30,52,82
01/11/2024,35,131,166,20,59,79,0,0,0,0,0,0,4,4,8,4,3,7,46,143,189,21,59,80
01/12/2024,17,61,78,16,33,49,0,0,0,0,0,0,1,1,2,1,1,2,22,67,89,17,33,50
01/13/2024,11,105,116,9,38,47,0,0,0,0,0,0,1,1,2,1,1,2,12,118,130,9,38,47
01/14/2024,2,105,107,2,34,36,0,0,0,0,0,0,0,0,0,0,0,0,2,108,110,2,34,36
01/15/2024,32,83,115,23,40,63,0,0,0,0,0,0,3,1,4,3,1,4,40,91,131,24,40,64
01/16/2024,23,154,177,18,61,78,0,0,0,0,0,0,0,4,4,0,2,2,25,172,197,18,61,78
01/17/2024,40,114,154,21,56,77,0,0,0,0,0,0,1,6,7,1,4,5,45,132,177,21,56,77
01/18/2024,22,137,159,16,47,63,0,0,0,0,0,0,1,6,7,1,5,6,26,153,179,16,47,63
01/19/2024,30,76,106,20,37,56,0,0,0,0,0,0,2,5,7,2,4,6,35,87,122,20,37,56
01/20/2024,26,61,87,11,27,38,0,0,0,0,0,0,4,0,4,4,0,4,37,62,99,11,27,38
01/21/2024,0,0,0,0,0,0,0,0,0,0,0,0,0,0,0,0,0,0,0,0,0,0,0,0
01/22/2024,63,140,203,30,60,90,0,0,0,0,0,0,2,3,5,2,3,5,72,160,232,30,60,90
01/23/2024,38,76,114,26,31,57,0,0,0,0,0,0,0,0,0,0,0,0,46,79,125,26,31,57
01/24/2024,24,118,142,19,55,74,0,0,0,0,0,0,3,1,4,2,1,3,29,135,164,19,55,74
01/25/2024,53,121,174,17,46,63,0,0,0,0,0,0,1,2,3,1,2,3,60,131,191,17,46,63
01/26/2024,32,90,122,17,36,53,0,0,0,0,0,0,0,0,0,0,0,0,35,90,125,18,36,54
01/27/2024,19,107,126,13,48,61,0,0,0,0,0,0,1,2,3,1,2,3,24,118,142,13,48,61
01/28/2024,21,85,106,12,44,56,0,0,0,0,0,0,2,0,2,2,0,2,30,87,117,12,44,56
01/29/2024,10,59,69,9,22,31,0,0,0,0,0,0,0,1,1,0,1,1,10,63,73,9,22,31
01/30/2024,28,80,108,22,38,60,0,0,0,0,0,0,1,0,1,1,0,1,33,81,114,22,38,60
01/31/2024,19,77,96,14,39,53,0,0,0,0,0,0,0,0,0,0,0,0,23,81,104,14,39,53
02/01/2024,15,78,93,12,36,48,0,0,0,0,0,0,0,0,0,0,0,0,18,84,102,13,36,49
02/02/2024,16,65,81,14,30,44,0,0,0,0,0,0,0,0,0,0,0,0,19,77,96,14,30,44
02/03/2024,7,92,99,5,31,36,0,0,0,0,0,0,0,0,0,0,0,0,8,102,110,5,31,36
02/04/2024,9,89,98,7,28,35,0,0,0,0,0,0,0,0,0,0,0,0,9,94,103,7,28,35
02/05/2024,22,58,80,16,26,42,0,0,0,0,0,0,0,2,2,0,2,2,24,63,87,16,26,42
02/06/2024,7,72,79,6,30,36,0,0,0,0,0,0,0,0,0,0,0,0,9,74,83,6,30,36
02/07/2024,24,74,98,15,46,60,0,0,0,0,0,0,2,0,2,2,0,2,27,78,105,16,46,61
02/08/2024,12,83,95,12,36,48,0,0,0,0,0,0,0,1,1,0,1,1,13,90,103,13,36,49
02/09/2024,16,128,144,14,42,56,0,0,0,0,0,0,0,0,0,0,0,0,18,134,152,14,42,56
02/10/2024,26,88,114,15,36,50,0,0,0,0,0,0,0,1,1,0,1,1,30,103,133,16,36,51
02/11/2024,23,34,57,9,23,32,0,0,0,0,0,0,1,2,3,1,1,2,31,41,72,10,23,33
02/12/2024,24,55,79,20,24,44,0,0,0,0,0,0,0,1,1,0,1,1,28,57,85,20,24,44
02/13/2024,15,107,122,11,42,52,0,0,0,0,0,0,1,3,4,1,3,4,18,122,140,11,42,52
02/14/2024,18,168,186,17,68,85,0,0,0,0,0,0,2,4,6,2,4,6,22,198,220,17,68,85
02/15/2024,31,117,148,22,53,74,0,0,0,0,0,0,4,0,4,3,0,3,36,125,161,22,53,74
02/16/2024,16,111,127,14,49,63,0,0,0,0,0,0,0,1,1,0,1,1,21,126,147,15,49,64
02/17/2024,18,78,96,6,37,43,0,0,0,0,0,0,0,2,2,0,1,1,25,81,106,6,37,43
02/18/2024,18,98,116,13,53,66,0,0,0,0,0,0,3,1,4,2,1,3,27,99,126,13,53,66
02/19/2024,39,115,154,24,48,72,0,0,0,0,0,0,4,0,4,4,0,4,46,126,172,24,48,72
02/20/2024,18,66,84,10,25,35,0,0,0,0,0,0,0,0,0,0,0,0,19,77,96,10,25,35
02/21/2024,30,95,125,24,47,71,0,0,0,0,0,0,0,3,3,0,3,3,32,107,139,24,47,71
02/22/2024,51,127,178,33,58,88,0,0,0,0,0,0,6,4,10,5,3,8,65,148,213,33,58,88
02/23/2024,63,138,201,39,53,91,0,0,0,0,0,0,1,4,5,1,4,5,70,158,228,39,53,91
02/24/2024,42,236,278,26,97,123,0,0,0,0,0,0,5,10,15,5,6,11,51,275,326,26,97,123
02/25/2024,35,121,156,22,55,76,0,0,0,0,0,0,2,2,4,1,2,3,42,140,182,23,55,77
02/26/2024,54,154,208,39,78,117,0,0,0,0,0,0,5,5,10,4,4,8,74,183,257,39,78,117
02/27/2024,64,240,304,38,99,137,0,0,0,0,0,0,4,6,10,3,4,7,78,266,344,38,99,137
02/28/2024,62,216,278,43,94,134,0,0,0,0,0,0,2,4,6,2,4,6,70,234,304,43,94,134
02/29/2024,29,138,167,22,61,83,0,0,0,0,0,0,3,7,10,3,6,9,39,159,198,22,61,83
03/01/2024,34,160,194,26,79,105,0,0,0,0,0,0,3,3,6,3,3,6,42,188,230,26,79,105
03/02/2024,20,108,128,13,52,65,0,0,0,0,0,0,5,4,9,5,3,8,29,119,148,13,52,65
03/03/2024,17,95,112,12,38,49,0,0,0,0,0,0,0,1,1,0,1,1,20,116,136,12,38,49
03/04/2024,29,134,163,22,53,74,0,0,0,0,0,0,4,0,4,4,0,4,35,152,187,22,53,74
03/05/2024,44,98,142,24,43,67,0,0,0,0,0,0,1,0,1,1,0,1,52,101,153,25,43,68
03/06/2024,31,114,145,15,35,50,0,0,0,0,0,0,2,2,4,2,2,4,36,127,163,15,35,50
03/07/2024,15,108,123,14,27,41,0,0,0,0,0,0,1,23,24,1,4,5,19,155,174,14,27,41
03/08/2024,10,49,59,8,18,26,0,0,0,0,0,0,1,3,4,1,1,2,14,54,68,8,18,26
03/09/2024,4,61,65,3,24,27,0,0,0,0,0,0,0,9,9,0,4,4,4,87,91,3,24,27
03/10/2024,13,69,82,7,29,35,0,0,0,0,0,0,2,4,6,1,4,5,18,81,99,7,29,35
03/11/2024,28,101,129,19,28,47,0,0,0,0,0,0,3,5,8,3,3,6,36,133,169,19,28,47
03/12/2024,26,64,90,18,23,41,0,0,0,0,0,0,1,3,4,1,2,3,29,81,110,18,23,41
03/13/2024,9,61,70,8,23,31,0,0,0,0,0,0,1,2,3,1,2,3,11,65,76,8,23,31
03/14/2024,10,56,66,8,22,30,0,0,0,0,0,0,0,1,1,0,1,1,12,60,72,8,22,30
03/15/2024,19,58,77,7,24,31,0,0,0,0,0,0,1,5,6,1,4,5,21,67,88,7,24,31
03/16/2024,6,43,49,4,20,24,0,0,0,0,0,0,0,1,1,0,1,1,8,46,54,4,20,24
03/17/2024,1,85,86,1,19,20,0,0,0,0,0,0,0,1,1,0,1,1,1,93,94,1,19,20
03/18/2024,24,83,107,13,28,41,0,0,0,0,0,0,2,1,3,2,1,3,31,99,130,13,28,41
03/19/2024,34,38,72,14,15,29,0,0,0,0,0,0,1,3,4,1,3,4,37,48,85,14,15,29
03/20/2024,13,57,70,9,21,30,0,0,0,0,0,0,0,2,2,0,2,2,14,64,78,9,21,30
03/21/2024,11,66,77,8,27,35,0,0,0,0,0,0,0,2,2,0,2,2,11,70,81,8,27,35
03/22/2024,8,21,29,4,12,16,0,0,0,0,0,0,0,0,0,0,0,0,9,23,32,4,12,16
03/23/2024,7,31,38,5,14,19,0,0,0,0,0,0,0,5,5,0,4,4,9,38,47,6,14,20
03/24/2024,9,41,50,7,17,24,0,0,0,0,0,0,1,1,2,1,1,2,13,48,61,8,17,25
03/25/2024,17,39,56,8,13,21,0,0,0,0,0,0,4,0,4,1,0,1,27,49,76,8,13,21
03/26/2024,22,37,59,9,21,30,0,0,0,0,0,0,2,2,4,2,1,3,27,41,68,11,21,32
03/27/2024,10,33,43,8,17,25,0,0,0,0,0,0,0,1,1,0,1,1,11,34,45,8,17,25
03/28/2024,16,56,72,9,22,31,0,0,0,0,0,0,2,4,6,2,3,5,18,73,91,9,22,31
03/29/2024,11,23,34,7,11,18,0,0,0,0,0,0,2,1,3,2,1,3,14,27,41,7,11,18
03/30/2024,7,53,60,3,17,20,0,0,0,0,0,0,1,3,4,1,3,4,8,63,71,3,17,20
03/31/2024,5,57,62,4,24,28,0,0,0,0,0,0,0,5,5,0,4,4,5,65,70,4,24,28
04/01/2024,5,72,77,4,25,29,0,0,0,0,0,0,1,4,5,1,4,5,8,82,90,4,25,29
04/02/2024,13,69,82,12,27,39,0,0,0,0,0,0,1,2,3,1,2,3,16,75,91,12,27,39
04/03/2024,21,118,139,19,60,79,0,0,0,0,0,0,2,3,5,1,3,4,24,125,149,19,60,79
04/04/2024,48,221,269,41,92,132,0,0,0,0,0,0,2,5,7,2,5,7,53,251,304,41,92,132
04/05/2024,31,166,197,24,74,98,0,0,0,0,0,0,2,5,7,2,5,7,35,177,212,24,74,98
04/06/2024,29,188,217,18,97,114,0,0,0,0,0,0,0,7,7,0,7,7,34,202,236,18,97,114
04/07/2024,38,243,281,24,114,137,0,0,0,0,0,0,2,5,7,2,5,7,43,263,306,24,114,137
04/08/2024,64,169,233,51,78,129,0,0,0,0,0,0,4,4,8,4,4,8,76,187,263,51,78,129
04/09/2024,37,158,195,24,75,98,0,0,0,0,0,0,1,6,7,1,5,6,45,189,234,24,75,98
04/10/2024,48,247,295,36,115,151,0,0,0,0,0,0,5,16,21,5,14,19,60,284,344,36,115,151
04/11/2024,79,151,230,43,81,124,0,0,0,0,0,0,7,8,15,6,6,12,97,167,264,43,81,124
04/12/2024,53,245,298,44,112,155,0,0,0,0,0,0,4,19,23,4,13,17,59,284,343,44,112,155
04/13/2024,31,217,248,20,95,115,0,0,0,0,0,0,1,9,10,1,8,9,34,247,281,20,95,115
04/14/2024,37,335,372,29,124,152,0,0,0,0,0,0,2,14,16,2,12,14,41,383,424,29,124,152
04/15/2024,78,323,401,59,118,175,0,0,0,0,0,0,3,17,20,3,15,18,85,358,443,59,118,175
04/16/2024,67,208,275,54,114,167,0,0,0,0,0,0,3,10,13,3,10,13,73,235,308,54,114,167
04/17/2024,72,308,380,42,135,175,0,0,0,0,0,0,9,20,29,5,18,23,96,374,470,42,135,175
04/18/2024,54,234,288,44,116,159,0,0,0,0,0,0,3,16,19,3,12,15,64,270,334,44,116,159
04/19/2024,73,265,338,53,122,173,0,0,0,0,0,0,14,16,30,8,13,21,108,300,408,53,122,173
04/20/2024,32,348,380,25,141,165,0,0,0,0,0,0,4,22,26,4,18,22,41,399,440,25,141,165
04/21/2024,54,302,356,35,136,168,0,0,0,0,0,0,3,14,17,3,12,15,61,339,400,35,136,168
04/22/2024,85,279,364,58,128,185,0,0,0,0,0,0,7,16,23,7,14,21,99,318,417,58,128,185
04/23/2024,62,259,321,40,135,173,0,0,0,0,0,0,7,13,20,5,12,17,77,289,366,40,135,173
04/24/2024,85,374,459,59,163,220,0,0,0,0,0,0,5,22,27,3,20,23,105,421,526,59,163,220
04/25/2024,79,351,430,53,164,215,0,0,0,0,0,0,6,10,16,6,9,15,94,394,488,53,164,215
04/26/2024,51,254,305,41,110,150,0,0,0,0,0,0,6,14,20,5,11,16,58,285,343,41,110,150
04/27/2024,60,326,386,33,147,180,0,0,0,0,0,0,2,13,15,2,12,14,64,369,433,33,147,180
04/28/2024,42,386,428,29,165,192,0,0,0,0,0,0,4,20,24,3,18,21,55,452,507,30,165,193
04/29/2024,59,275,334,42,135,177,0,0,0,0,0,0,5,13,18,5,12,17,65,321,386,43,135,178
04/30/2024,69,249,318,50,110,160,0,0,0,0,0,0,5,10,15,5,10,15,80,290,370,52,111,163
05/01/2024,46,216,262,28,86,114,0,0,0,0,0,0,4,10,14,4,7,11,53,247,300,28,86,114
05/02/2024,42,197,239,34,86,120,0,0,0,0,0,0,7,17,24,7,11,18,52,243,295,35,86,121
05/03/2024,42,168,210,32,75,106,0,0,0,0,0,0,5,5,10,4,4,8,49,186,235,32,75,106
05/04/2024,33,249,282,19,95,114,0,0,0,0,0,0,5,24,29,2,17,19,43,301,344,20,95,115
05/05/2024,12,90,102,11,43,54,0,0,0,0,0,0,1,7,8,1,6,7,18,100,118,12,43,55
05/06/2024,39,90,129,29,47,76,0,0,0,0,0,0,5,4,9,4,4,8,46,108,154,29,47,76
05/07/2024,55,258,313,39,123,161,0,0,0,0,0,0,4,17,21,3,14,16,67,287,354,39,123,161
05/08/2024,57,227,284,40,97,137,0,0,0,0,0,0,7,12,19,7,9,16,69,274,343,41,97,138
05/09/2024,51,204,255,35,93,127,0,0,0,0,0,0,2,13,15,2,11,13,64,233,297,35,93,127
05/10/2024,20,175,195,16,67,83,0,0,0,0,0,0,2,15,17,2,9,11,28,216,244,16,67,83
05/11/2024,13,136,149,8,55,63,0,0,0,0,0,0,3,10,13,2,8,10,19,164,183,8,55,63
05/12/2024,23,109,132,17,48,65,0,0,0,0,0,0,6,6,12,4,6,10,32,119,151,17,49,66
05/13/2024,20,85,105,16,38,54,0,0,0,0,0,0,2,4,6,2,3,5,23,92,115,16,38,54
05/14/2024,20,99,119,17,44,61,0,0,0,0,0,0,2,12,14,2,6,8,23,133,156,17,44,61
05/15/2024,33,178,211,27,87,111,0,0,0,0,0,0,2,8,10,2,8,10,40,199,239,28,87,112
05/16/2024,56,179,235,36,83,119,0,0,0,0,0,0,4,7,11,4,6,10,65,197,262,36,85,121
05/17/2024,44,197,241,35,86,119,0,0,0,0,0,0,1,19,20,1,16,17,48,245,293,35,90,123
05/18/2024,20,134,154,13,82,95,0,0,0,0,0,0,3,11,14,3,9,12,25,155,180,13,86,99
05/19/2024,37,158,195,25,81,106,0,0,0,0,0,0,0,13,13,0,9,9,46,185,231,26,82,108
05/20/2024,35,191,226,31,84,115,0,0,0,0,0,0,2,10,12,2,10,12,38,220,258,31,85,116
05/21/2024,60,157,217,42,80,121,0,0,0,0,0,0,3,17,20,3,15,18,64,196,260,42,81,122
05/22/2024,43,193,236,29,101,130,0,0,0,0,0,0,3,13,16,2,12,14,55,227,282,29,105,134
05/23/2024,139,332,471,89,151,240,0,0,0,0,0,0,5,27,32,5,24,29,154,409,563,89,159,248
05/24/2024,62,185,247,43,92,134,0,0,0,0,0,0,5,17,22,5,16,21,76,228,304,43,101,143
05/25/2024,50,233,283,28,101,129,0,0,0,0,0,0,4,20,24,3,16,19,58,282,340,28,104,132
05/26/2024,32,142,174,21,82,102,0,0,0,0,0,0,4,14,18,4,10,14,43,186,229,21,86,106
05/27/2024,122,207,329,40,87,127,0,0,0,0,0,0,3,8,11,3,8,11,135,233,368,40,92,130
05/28/2024,93,251,344,59,126,184,0,0,0,0,0,0,8,20,28,7,20,27,115,315,430,59,131,189
05/29/2024,67,230,297,45,89,133,0,0,0,0,0,0,3,12,15,3,8,11,73,263,336,45,94,138
05/30/2024,77,209,286,43,74,117,0,0,0,0,0,0,2,5,7,2,5,7,80,228,308,43,74,117
05/31/2024,56,203,259,39,75,113,0,0,0,0,0,0,4,9,13,4,9,13,69,231,300,39,78,116
06/01/2024,25,177,202,17,62,79,0,0,0,0,0,0,0,12,12,0,8,8,26,205,231,17,67,84
06/02/2024,29,256,285,23,99,122,0,0,0,0,0,0,1,15,16,1,12,13,32,305,337,23,102,125
06/03/2024,74,196,270,46,81,127,0,0,0,0,0,0,5,17,22,3,13,16,89,236,325,46,82,128
06/04/2024,53,197,250,40,87,127,0,0,0,0,0,0,7,26,33,5,22,27,63,244,307,40,97,137
06/05/2024,52,183,235,37,83,120,0,0,0,0,0,0,9,16,25,7,10,17,69,222,291,37,86,123
06/06/2024,49,201,250,40,110,150,0,0,0,0,0,0,7,18,25,7,14,21,59,249,308,41,112,153
06/07/2024,53,238,291,40,135,175,0,0,0,0,0,0,3,21,24,3,16,19,61,284,345,40,135,175
06/08/2024,35,188,223,23,111,134,0,0,0,0,0,0,1,11,12,1,8,9,39,213,252,23,111,134
06/09/2024,24,203,227,16,118,134,0,0,0,0,0,0,2,12,14,2,12,14,27,244,271,16,118,134
06/10/2024,62,236,298,44,137,180,0,0,0,0,0,0,11,13,24,8,12,20,77,264,341,44,137,180
06/11/2024,88,413,501,65,216,279,0,0,0,0,0,0,7,23,30,7,21,28,101,464,565,66,217,281
06/12/2024,70,180,250,55,106,161,0,0,0,0,0,0,4,19,23,4,14,18,84,221,305,55,108,163
06/13/2024,63,129,192,32,92,123,0,0,0,0,0,0,2,14,16,2,12,14,67,159,226,32,94,125
06/14/2024,83,188,271,36,107,143,0,0,0,0,0,0,5,10,15,5,9,14,93,217,310,36,108,144
06/15/2024,39,308,347,32,168,198,0,0,0,0,0,0,6,18,24,5,15,20,46,360,406,32,169,199
06/16/2024,51,223,274,31,142,171,0,0,0,0,0,0,11,12,23,7,11,18,63,255,318,31,147,176
06/17/2024,72,234,306,44,148,191,0,0,0,0,0,0,8,42,50,8,28,36,92,321,413,45,149,193
06/18/2024,89,211,300,53,142,195,0,0,0,0,0,0,4,19,23,3,17,20,106,274,380,53,148,200
06/19/2024,61,174,235,42,113,155,0,0,0,0,0,0,8,15,23,7,15,22,73,245,318,42,126,168
06/20/2024,82,173,255,60,103,163,0,0,0,0,0,0,6,20,26,6,17,23,99,255,354,60,115,175
06/21/2024,74,185,259,52,116,166,0,0,0,0,0,0,6,17,23,4,15,19,89,290,379,52,140,190
06/22/2024,45,135,180,31,83,113,0,0,0,0,0,0,4,22,26,3,16,19,50,240,290,31,101,131
06/23/2024,37,146,183,24,91,115,0,0,0,0,0,0,1,12,13,1,10,11,44,207,251,24,108,132
06/24/2024,75,156,231,54,79,132,0,0,0,0,0,0,4,11,15,4,9,13,91,223,314,56,98,153
06/25/2024,80,135,215,58,84,141,0,0,0,0,0,0,6,20,26,6,14,20,99,200,299,58,96,153
06/26/2024,50,106,156,40,67,106,0,0,0,0,0,0,3,11,14,2,11,13,60,162,222,40,86,125
06/27/2024,37,95,132,27,60,87,0,0,0,0,0,0,4,22,26,3,20,23,45,188,233,28,95,123
06/28/2024,89,133,222,45,81,125,0,0,0,0,0,0,11,14,25,8,13,21,110,263,373,45,117,161
06/29/2024,43,158,201,34,100,134,0,0,0,0,0,0,2,17,19,2,17,19,48,303,351,34,153,187
06/30/2024,38,154,192,30,85,114,0,0,0,0,0,0,2,20,22,2,14,16,42,297,339,30,141,170
07/01/2024,77,121,198,58,80,138,0,0,0,0,0,0,5,15,20,5,13,18,90,219,309,58,112,170
07/02/2024,45,122,167,41,72,113,0,0,0,0,0,0,5,27,32,5,22,27,54,257,311,42,122,164
07/03/2024,39,87,126,32,50,82,0,0,0,0,0,0,2,10,12,2,9,11,43,174,217,32,91,123
07/04/2024,38,83,121,31,49,79,0,0,0,0,0,0,1,10,11,1,10,11,45,167,212,32,90,120
07/05/2024,59,121,180,29,56,84,0,0,0,0,0,0,3,12,15,3,12,15,67,199,266,29,79,107
07/06/2024,19,72,91,18,46,64,0,0,0,0,0,0,2,6,8,2,4,6,23,142,165,19,78,97
07/07/2024,34,102,136,26,63,89,0,0,0,0,0,0,4,19,23,4,16,20,45,245,290,26,115,141
07/08/2024,60,91,151,47,65,112,0,0,0,0,0,0,4,18,22,4,15,19,68,204,272,48,113,161
07/09/2024,86,136,222,45,85,130,0,0,0,0,0,0,9,23,32,9,21,30,107,237,344,46,127,173
07/10/2024,68,118,186,48,84,131,0,0,0,0,0,0,7,34,41,6,31,37,79,288,367,48,158,205
07/11/2024,72,134,206,49,75,124,0,0,0,0,0,0,8,15,23,6,14,20,84,237,321,49,123,171
07/12/2024,72,90,162,51,56,107,0,0,0,0,0,0,2,19,21,2,18,20,78,192,270,51,90,141
07/13/2024,31,104,135,28,60,88,0,0,0,0,0,0,2,27,29,2,20,22,36,231,267,28,115,142
07/14/2024,30,109,139,22,61,83,0,0,0,0,0,0,5,23,28,5,17,22,38,225,263,22,119,141
07/15/2024,97,97,194,60,64,124,0,0,0,0,0,0,5,14,19,4,12,16,109,188,297,60,116,175
07/16/2024,70,154,224,45,92,137,0,0,0,0,0,0,6,21,27,6,16,22,81,268,349,45,139,184
07/17/2024,76,118,194,53,81,132,0,0,0,0,0,0,10,24,34,7,17,24,99,274,373,53,127,177
07/18/2024,61,74,135,38,56,94,0,0,0,0,0,0,7,17,24,5,16,21,73,199,272,38,115,153
07/19/2024,57,87,144,42,62,104,0,0,0,0,0,0,7,18,25,5,14,19,67,203,270,42,114,156
07/20/2024,53,124,177,33,71,104,0,0,0,0,0,0,6,14,20,5,13,18,62,256,318,33,139,172
07/21/2024,59,117,176,43,82,124,0,0,0,0,0,0,7,29,36,7,26,33,68,275,343,43,146,188
07/22/2024,81,137,218,64,79,143,0,0,0,0,0,0,2,17,19,2,16,18,88,240,328,64,122,186
07/23/2024,68,92,160,48,66,114,0,0,0,0,0,0,5,22,27,5,19,24,81,194,275,48,102,150
07/24/2024,63,127,190,37,80,117,0,0,0,0,0,0,3,23,26,3,19,22,69,217,286,37,113,150
07/25/2024,60,124,184,34,82,114,0,0,0,0,0,0,1,13,14,1,11,12,69,205,274,34,107,139
07/26/2024,51,90,141,33,64,97,0,0,0,0,0,0,3,23,26,3,10,13,56,163,219,33,84,117
07/27/2024,23,67,90,17,43,60,0,0,0,0,0,0,2,17,19,2,6,8,26,133,159,17,60,77
07/28/2024,33,77,110,24,40,64,0,0,0,0,0,0,1,6,7,1,5,6,36,145,181,25,72,96
07/29/2024,40,60,100,20,43,63,0,0,0,0,0,0,5,15,20,5,12,17,51,121,172,21,69,90
07/30/2024,34,61,95,21,35,56,0,0,0,0,0,0,7,14,21,5,11,16,45,112,157,21,55,76
07/31/2024,38,48,86,22,37,59,0,0,0,0,0,0,2,14,16,2,11,13,43,105,148,22,53,75
08/01/2024,61,141,202,44,95,137,0,0,0,0,0,0,6,10,16,5,10,15,82,220,302,44,118,160
08/02/2024,50,65,115,39,38,77,0,0,0,0,0,0,4,9,13,3,9,12,57,128,185,40,68,108
08/03/2024,37,46,83,25,34,58,0,0,0,0,0,0,2,10,12,2,8,10,39,147,186,25,72,96
08/04/2024,34,59,93,27,39,66,0,0,0,0,0,0,4,13,17,4,11,15,39,185,224,27,94,120
08/05/2024,88,92,180,63,50,113,0,0,0,0,0,0,5,26,31,4,20,24,100,234,334,63,107,170
08/06/2024,77,98,175,53,61,114,0,0,0,0,0,0,4,18,22,3,14,17,89,225,314,54,117,170
08/07/2024,96,100,196,47,69,115,0,0,0,0,0,0,7,21,28,6,19,25,119,219,338,47,126,172
08/08/2024,86,108,194,57,70,127,0,0,0,0,0,0,4,18,22,4,16,20,98,230,328,58,115,172
08/09/2024,75,77,152,48,52,100,0,0,0,0,0,0,5,6,11,5,5,10,82,133,215,49,84,133
08/10/2024,62,113,175,34,71,104,0,0,0,0,0,0,4,15,19,4,9,13,72,199,271,34,108,139
